0000000000
0211011100
0001110112
0111000100
0103111100
0100010100
0111110112
0000000000